*********************
*       *           *
*       *           *
*       *           *
*       *           *
*       *           *
*                   *
*********************