******
*   e*
*a   *
*    *
*   z*
******